rfkr	rfkr
kdfh	kdfh
aoye	anye
wppe	wppe
jhsz	jhsz
icis	iccs
oqhx	oqhx
lzxr	wzxr
vuvw	vovw
bmkw	blkw
ydas	yday
xqrr	xqrr
mipl	mipb
kxqe	kxve
oeux	oeux
pthc	pthc
hvmk	hvmk
jkvd	jkvm
xrwk	xrwk
whdo	whno
igxq	igxq
vbop	vbep
omvy	omdy
bqhk	bqhk
ardb	ardb
nzfk	nzfu
remw	remw
ixpm	ixpm
hmqr	rmqr
qige	qige
gxyz	gxyz
srty	szty
wotw	iotw
xutz	xutk
kedr	yedr
wlqq	wrqq
japw	japw
nleo	sleo
xvnp	xvnp
qrzh	qrzh
