vuof	guof
dggu	dggu
jrit	brit
nhyr	nhur
qoog	coog
shye	shye
xllm	xllm
plxq	plxq
mwdw	mpdw
ptlx	ptlx
rypw	rzpw
vjkb	vjob
qaqt	qaqt
vrsc	vrsn
noiu	noiu
nbns	ubns
wxty	wxty
mdhv	mdnv
bcat	bcat
ceyq	clyq
ockn	ockn
aahe	aahk
mztf	mbtf
kfgc	kfgc
jsqn	jsqy
lqpk	lqnk
ehpl	ehpl
qjlc	qjlc
aocw	nocw
lims	lims
mrfy	mrey
upth	upth
vynz	vynz
ctjg	ctjg
opan	opaw
ucyl	uiyl
hoag	hoag
ecpq	ecpj
tlrg	tlrg
glhw	glhw
