guyp	guop
zmvx	zmvx
bnbp	jnbp
shff	shnf
hcyt	hcrt
kloo	kloo
xcvf	xzvf
ezew	ezen
joqd	jkqd
cfyg	cfyl
uprz	uprz
xzvz	xzvz
qefl	qefl
tjzs	tjzs
emix	emzx
kska	rska
vomh	vomh
hkhn	hkhn
zjwi	zjwi
krwq	krwb
otcs	otcs
rqiu	rqiu
bebo	bdbo
lxuf	lxuf
rjga	rjga
jsrp	lsrp
mvxv	zvxv
qzqr	qzqr
fmxv	frxv
qlnj	qlnj
muqo	muqo
qlnv	qlnv
mesr	eesr
nsgj	nsgq
gphf	gphf
sqxu	scxu
opxp	opxc
zbbu	zbbu
zrxj	zrxj
yjgr	yjpr
